1111111111111111111111111111111111
1E1000000000001C10000C100000000001
1110010100100000101001000000010101
1010010010101010001001000000010101
1P0000000C00C0000000001000000000C1
1111111111111111111111111111111111