1111111111111111111111111111
1C01000000000110C11100000011
1001000010000E100000000000C1
1000000011111110000000011111
1111100000111000000000000001
100000000011100000P000010011
1C10000000000001111110010001
111100100000000100N000011001
1000001110110001000010010001
10000000001C000000001001C001
1111111111111111111111111111