1111111111111111111111111111
1C01000000000110C11100000011
1001000010000E100000000000C1
1000000011111110000000011111
1111100000111000000000000001
1000000000111000000000010011
1C10000000000001111110010001
11110010000N0001000000011001
1000001110110001000010010001
10P00000001C000000001001C001
1111111111111111111111111111