1111111111111111111
100C0P0C10000000C11
1011011101011101101
1011011101011101101
1C00000000000000001
1011010111110101101
1000C10001000100001
1111011101011101111
11C10100000C0101011
1101010110110101011
110000010E010000C11
1101010111110101011
1101010000000101011
1111010111110101111
100000C0010000C0001
1011011101011101101
1001000000000001001
1101010111110101011
1100010001000100001
1011111101011111101
1C0000000000C0000C1
1111111111111111111