1111111111111111111111111111111
10E100C000000000000000100000001
1011011111111000111011100111001
10011000P0101000001000001100011
1101101110101011110001111001001
11001C10000000100C0001C10011101
1C10111011111000111001010011C01
1000C00001100000001111000001001
1111111111111111111111111111111