1111111
1CEP111
1111111
1111111