1111111111111111111111111111111111111111111111111
1000100010001000100010001000100010001000100010001
101C1C1C1C1C1C1C1C1C1C1C1C1C1C1C1C1C1C1C1C1C1C1C1
1P100010001000100010001000100010001000100010001E1
1111111111111111111111111111111111111111111111111